1111111111111111111111111111111111111111
10001111101001000100001000000C0000000001
1000100C00100010010001000000000000000001
100010001000C000001001000C000C0000000011
10001111110000000001000C0C00000000000111
1000P000C0000000001000C00000000000000011
10000000000100000100000000000C0000000011
100000C0000C000001000C000000000000000011
100000CC00010C000E0000000000000000000011
1000000C000100000100000000000C0000000011
1000000000010000000000000000000000000101
1111111111111111111111111111111111111111