1111111111111111111111111111111111111111111111111111111111111111111111111111111111111
111111C000000000000000000000000000000000000000000000000000000000000000000000000000001
1000010000000000000000000000000000000000000000000000000000000000000000000000000000001
1000010000000000000000000000000000000000000000000000000000000001111000000000000000001
10000100000000000000000000000000011111111111000000000000000000010C0000000000000000001
10000100000000000000000000000000011CCCCCCCC100000000000000000001111000000000000000001
10000100000000000000000000000000011CCCCCCCC000000000000000000000000000000000000000001
1000010000000000000000000000000001111111111100000000000000000000000000000000000000001
1000010000000000000000000000000000000000000000000000000000000000000000000000000000001
1000010000000000000000000000000000000000000000000000000000000000000000000000000000001
1000010000000000000000000000000000000000000000000000000000000000000000000000000000001
1011110000000000000000000000000000000000000000000000000000000000000000000000000000001
101E000000000000000000000000000000000000000000000000000000000000000000000000000000P01
1111111111111111111111111111111111111111111111111111111111111111111111111111111111111