1111111111111111111111111111111111111111
10001111101001000100001000000C0000000001
1000100C00100010010001000000000000000001
100010001000C000001001000C000C0000000011
11111111110000000001000C0C00000000000111
10000000C0000000001000C00000000000000011
10000000000100000100000000000C0000000011
100000C0000C000001100C000000000000000011
100000CC00010C001E0100000000000000000011
1000000C000100000100000000000C0011011111
100000000001000000000000000000001000P101
1111111111111111111111111111111111111111