11111111111111111111111111
10111000010100000001011101
10000000001000000100000101
11011101011111001011110111
10000010000000000010010111
10010001001111111111100001
10001000010EP0101000001111
10010000001111111000100001
10000000010000000000100001
11111111111111111111111111