1111111111111111111111
1000000001000100010001
1000000000100010010001
100000010P000000010001
10000001000100111E0001
1111111111111111111111