11111111111111111111111111
1000000C000000000000001001
10000000000000000000001001
100000C0011111000100001001
100000000C0000000000000E11
10000000000000000000100P01
11111111111111111111111111