111111111111111111111111111111111111111111111111111
111111C00000000000000000000000000000000000000000001
100001000000000000000000000000000000000000000000001
100001000000000000000000000000000000000000001110001
1000010000000000000000000000000001111111111110C0001
10000100000000000000000000000000011CCCCCCCC11110001
10000100000000000000000000000000011CCCCCCCC00000001
100001000000000000000000000000000111111111110000001
100001000000000000000000000000000000000000000000001
100001000000000000000000000000000000000000000000001
100001000000000000000000000000000000000000000000001
101111000000000000000000000000000000000000000000001
101111000000000000000000000000000000000000000000001
101111000000000000000000000000000000000000000000001
101111000000000000000000000000000000000000000000001
101111000000000000000000000000000000000000000000001
101111000000000000000000000000000000000000000000001
101111000000000000000000000000000000000000000000001
101111000000000000000000000000000000000000000000001
101111000000000000000000000000000000000000000000001
101111000000000000000000000000000000000000000000001
101111000000000000000000000000000000000000000000001
101111000000000000000000000000000000000000000000001
101111000000000000000000000000000000000000000000001
101111000000000000000000000000000000000000000000001
101111000000000000000000000000000000000000000000001
101E000000000000000000000000000000000000000000P0001
111111111111111111111111111111111111111111111111111
