1111111111111111111111111111111111111111
10001111101001000100001000000C0000000001
1000100C00100010010001000000000000000001
100010001000C000001001000C000C0000000011
11111111010000000001000C0C00000000000111
10000100C1111011111000C00000000000000011
10000100000100000100000000000C0000000011
100001C0000C000000000C000000000000000011
100001CC00010C000E0100000000000000000011
1000010C000000000000000000000C0011011111
100001111111000000000000000000001000P101
1111111111111111111111111111111111111111