1111111111111111111111111111111111111111111111111
1C1C000001010011111100000000000000000000000000001
1E11000000000000C00000000000000000000000000000001
100001C001000010010000000000000000CCCCCCCCCCCC1C1
100001C001000010010000000000000000CCCCCCCCCCCC1C1
1111111101000010010000000000000000CCCCCCCCCCCC1C1
1111111101000010010000000000000000CCCCCCCCCCCC1C1
1111111101000010010000000000000000CCCCCCCCCCCC1C1
1111111101000010010000000000000000CCCCCCCCCCCC1C1
1111111101000010010000000000000000CCCCCCCCCCCC1C1
1111111101000010010000000000000000CCCCCCCCCCCC1C1
1111111101000010010000000000000000CCCCCCCCCCCC1C1
1111111101000010010000000000000000000000000000001
1111111001000010010000000000000000000000000000001
1111111001000010010000000000000000000000000000001
1111111001000010010000000000000000000000000000001
1CCC111001000010010000000000000000000000000000001
1CCCCCP001000010010000000000000000000000000000001
1111111111111111111111111111111111111111111111111
