11111111111111111111111111
101110C00101C0000001011101
1000C0CC0C1000000100000101
110111C1011111000111110111
1000C01000000000001001C111
10000001000100001111100001
10000000000000000000PE1111
10000000000000000000100001
10000000000000000000100001
11111111111111111111111111