11111111111111111111111111
101110C00101C0000001011101
1000C0CC0C1000000100000101
110111C1011111001011110111
1000C01000000000001001C111
100100010011E1111111100001
100P1000010000101000001111
100100000C1111111000100001
10000000010000000000100001
11111111111111111111111111