1111111111111111111111
10000C0001C00100010001
100000C00C1C001C010001
10C000010P00C0E0010001
1000000100C10011010001
1111111111111111111111
