1111111111111111111111
1011100001010011111101
1E11000000000000CP0001
100001C001000010010001
100001C001000010010001
100001C001000010010001
100001C001000010010001
1111111111111111111111
