11111111111111111111111111
10000000000000000101011101
10000000000000000000000111
10000001011111001010100111
1000001C000000010PE0011111
10000001000000001111100001
11111111111111111111111111