1111111111111111111111
10000C0000C001P0000001
100000C0001C001C000001
10C000010000C0C0000001
1000000100C000E1000001
1111111111111111111111