1111111111111111111111
1P000C0001C00100000001
100000C00C1C001C000001
10C000010000C0C0000001
1000000100C100E1000001
1111111111111111111111
