11111111111111
100000PC000001
100000000E0001
11111111111111