1111111111
100000P0C1
10000E0011
1111111111