111111111111111111111111111111111111111111111111111
110000000000000000000000100000000000000000000000001
101000000000000000000001010000000000000000000000001
100100000000000000000010001000000000000000000000001
1000100000000000000001000001000000000000000000001C1
100001000000000000001000000010000000000000000001001
100000100000000000010000000001000000000000000010001
100000010000000000100000000000100000000000000100001
100000001000000001000000000000010000000000001000001
100000000100000010000000000000001000000000010000001
100000000010000100000000000000000100000000100000001
100000000001001000000000000000000010000001000000001
100000000000110000000000000000000001000010000000001
1E00000000000000000000000P0000000000000000000000001
100000000001001000000000000000000000000000000000001
100000000010000100000000000000000000011000000000001
100000000100000010000000000000000000100100000000001
100000001000000001000000000000000001000010000000001
100000010000000000100000000000000010000001000000001
100000100000000000010000000000000100000000100000001
100001000000000000001000000000001000000000010000001
100010000000000000000100000000010000000000001000001
100100000000000000000010000000100000000000000100001
101000000000000000000001000001000000000000000010001
110000000000000000000000100010000000000000000001001
100000000000000000000000010100000000000000000000101
100000000000000000000000001000000000000000000000011
111111111111111111111111111111111111111111111111111