1111111111
10P000CCC1
100000EC11
1111111111