11111111111111111111
1000C000010000000001
10000000010000P00001
1000E000010000000001
10000000010000000001
11111111111111111111