111111111111111
100000P0C000001
10000E001000001
111111111111111