111111111111111111111111111111111111111111111
100000000100000000010000100001000010000100001
100000000100000000010000100001000010000100001
100000000E00000000010000100001000010000100001
100000000100000000010000100001000010000100001
100000000100000000010000100001000010000100001
10000P000100000000010000100001000010000000001
100000000100000000010000100001000010000100001
100000000100000000010000100001000010000100001
100000000100000000010000100001000010000100001
100000000100000000000000000000000000000100001
100000000100000000010000100001000010000100001
100000000100000000010000100001000010000100001
100000000100000000010000100001000010000100001
100000000100000000010000100001000010000100C01
100000000000000000010000100001000010000100001
111111111111111111111111111111111111111111111