111111111111111111111111111111111111111111111111111
100000000000000000010000000000000000000000000000001
100000000000000000010000000000000000000000000000001
100000000000000000110000000000000000000000000000001
100000000000000001PE1000000000000000000000000000001
100000000100000001010000000000000000000000000000001
100000000100000000010000000000000000000000001110001
100000000111111111111000000000000000000000001C10001
100000000000000000000000000000000000000000000000111
111111111111111111111111111111111111111111111111111