1111111111111111111111111111
1E0010C000000000000000000001
10001110000000CCCCCCC0000001
1P000000000000CCCCCCC0000001
10000000000000CCCCCCC0000001
100C0000000000CCCCCCC0000001
1111111111111111111111111111