1111111111111111111111111111111111111111111111111111111111111111111111111111111111111
100001000000000000000000000000000000000000000000000000000000000                     1
100001000000000000000000000000000000000000000000000000000000000                     1
100001000000000000000000000000000000000000000000000000000000000                     1
100001000000000000000000000000000000000000000000000000000000000                     1
100001000000000000000000000000000000000000000000000000000000000                     1
100001000000000000000000000000000000000000000000000000000000000                     1
100001000000000000000000000000000000000000000000000000000000000                     1
100001000000000000000000000000000000000000000000000000000000000                     1
100001000000000000000000000000000000000000000000000000000000000                     1
100001000000000000000000000000000000000000000000000000000000000                     1
100E00000000000000000000000000000000000000000000000000000000000                     1
1111111111111111111111111111111111111111111111111111111111111111111111111111111111111