1111111
10100P1
1E11111
1000001
1111111