1111111111111111111
1P000000E01100000C1
10CCCCCCC0010000001
1111111111111111111