1111111111111111111
1P000000E0000000111
1000000000000000011
1000000000000000011
1000000000000000011
1000000000000000011
1000000000000000011
1000000000000000011
1000000000000000011
1000000000000000011
1000000000000000011
1000000000000000011
1000000000000000011
1000000000000000111
1000000000000001C11
1111111111111111111