1111111111111111
10000000000000E1
111101CC10000001
1000000000000001
1000000000000001
1110000000000001
1P01000000000001
1111111111111111