1111111111111111
1000000000000PE1
111101CC10000001
1000000000000001
1000000000000001
1110000000000001
1C11000000000001
1111111111111111